#Example: Large parts of Africa and south east Asia
tropical = {
			3184 3183 3182 3181 3180 3179 3178 3177 3176 3175 3173 3172 3170 3169 3168 3167 3166
			3165 3164 3162 3163 3161 3159 3063 3144 3192 3142 3141 3143 3145 3139 3140 3138 3136 
			3135 3191 3121 3190 3120 3185 3118 3058 3117 3186 3059 3057 3060 3054 3056 3053
			3052 3061 3055 3051 3050 3049 3046 3047 3062 3045 3044 3065 3064 3066 3038 3037
			3034 3035 3036 3032 3033 3031 3022 3019 3021 3018 3009 3008 3010 3193 3194 3198 3205
			3206 3204 3203 3197 921 922 923
}

arid = {
	632 633 634 635 539 535 537 631 538 532 541 540 542 543 536 544 545 551 553 556 596 555 552
	566 594 595 565 572 558 561 564 574 581 590 593 592 585 573 591 586 584 601 602 627 629 637
	716 717 715 718 719 712 711 1641 1640 1639 725 726 724 723 720 721 722 710 708 698 699 697 695 696
	660 663 658 659 713 661 666 656 657 662 650 652 654 694 649 648 646 638 636 651 653 655 665 647
	641 645 644 642 664 639 640 628 643 678 677 679 796 906 675 674 676 686 685 693 689 690 691 692
	700 703 702 727 733 787 786 788 789 790  792 791 793 794 3229 749 743 2252 2251 770 
	754 753 2249 756 755 760 757 758 761 759 762 763 780 781 785 783 795 782 778 777 779 776 775
	784 774 764 766 765 772 773 767 768 769 803 804 801 802 805 807 808 806 809 811 812 810 813 815 814
	821 818 817 819 816 830 820 829 828 823 822 824 825 826 848 849 844 845 846 839 841 843 840 842 
	831 827 855 834 835 836 837 929 838 860 861 847 832 833 2255 2254 2259 2258 2256 2266 2267 2260 2261 2257
	2529 2533 2534 2532 2530 2265 2262 2264 2276 2263 22702269 2268 2271 2272 2274 2275 2281 2296 2291 2524 2297
	2520 2521 2522 2545 2546 2519 2528 2523 2579 2580 2540 2536 2531 2547 2548 2538 2535 2537 2539 2714 
	2543 2544 2542 2541 2550 2552 2553 2549 2551 2555 2248 2525 2526 2303 2314 2311 2324 2313 2323 2351 2352 
	2366 2367 2364 2353 2354 2374 2480 3227 3228 2361 2360 2362 2363 2356 2357 2358 2514 2511 2510 2513 2359
	2517 2515 2512 2573 2564 2574 2575 2577 2587 2576 2578 2630 2629 2581 2580 2589 2588 2582 2583 2582 2584 2586 2585
	2650 2649 2651 2648 2646 2639 2644 2647 2642 2637 2640 2641 2645 2643 2638 2634 2635 2636 2633 2632 2603 2604 2625 2602 2601
	2622 2628 2623 2626 2621 2619 2613 2611 2612 2605 2620 2609 2607 2608 2606 2572 2567 2562 2568 2569 2570 2561 
	2557 2556 2554 2558 2559 2565 2563 2560
	2739 2717 2715 2747 2727 2750 2742 2744 2743 2741 2761 2815 2712 2740 2731 2730 2722 2745 2726 2729 2706 2728
	2704 2746 2726 2749 2771 2770 2762 2791 2813 2814 2778 2787 2772 2718 2773 2782 2748 2767 2780 2781 2779 2769
	2777 2776 2775 2792 2789 2790 2793 2795 2788 2786 2785 2812 2783 2768 2816 2784 2803 2804 2766 2763 2764 2838
	2884 2881 2887 2882 2885 2888 2901 2902 2886 2899 2870 2867 2889 2837 2836 2834 2833 2868 2874 2923 2955 2926 2952  
	892 894 893 891 890 889 887 886 884 2312 2309
}  

arctic = {

}

mild_winter = {
	
} 

normal_winter = {
	
}

severe_winter = {
	
}

impassable = {
	257 258 259 260 261 262 263 264 265 266 267 268 269 270 271 272 273 274 275 276 375 520 546
	667 668 669 670 671 672 673 684 687 688 714 771 797 798 799 800 850 851 852 853 854 899 900
	902 903 907 908 926 927 928 1008 1009 1010 1051 1057 1058 1059 1130 1161 1162 1197 1224 1827
	1828 1921 1927 1928 1929 1930 2032 2086 2087 2088 2112 2113 2138 2139 2140 2141 2142 2181
	2241 2240 2239 2247 2248 2250 2305 2315 2327 2330 2355 2365 2379 2383 2390 2399 2417 2418
	2419 2494 2495 2496 2527 2590 2591 2631 2752 2753 2754 2755 2756 2757 2758 2759 2760 2774
	2796 2797 2798 2799 2800 2807 2808 2809 2810 2843 2844 2847 2849 2850 2851 2852 2853 2854
	2855 2906 2925 2950 3040 3048 3112 3129 3154 3171 3155 3207 3217 3218 3219 3220 3221 3222
	3223 3225 3226 3233
	# Water Wasteland
	1593 1595 1596 1599 1600 1602 1608 1609 1610 1613 1625 1628 1630 1631 1632 1633 1634 1635 1636 1637 1638 1919
}
