europe = {
	  1 2 3 4 5 7 6 9 13 10 11 8 12 14 15 16 17 18 19 20 27 28 29 22 21 23 24 26 32 37 31 38 25 36 30 35 40 46 44 41 42 43 
	  39 34 33 45 48 53 52 51 50 54 49 55 47 56 60 59 57 58 78 61 63 62 64 65 66 67 68 72 69 74 73 71 70 75 76 77 81 80 
	  82 85 86 83 87 88 89 84 93 92 79 90 91 94 96 95 374 99 100 103 97 98 101 102 110 111 112 470 468 104 105 106 107 113
	  109 108 114 116 118 113 117 115 1212 119 121 120 122 123 124 129 128 130 131 127 132 126 125 366 365 370 373 367 
	  368 369 371 386 372 387 389 388 398 396 392 393 391 395 394 376 399 401 381 382 380 377 378 379 416 410 409 411 412
	  408 414 413 415 406 419 405 404 421 423 397 403 425 400 424 426 427 430 422 428 429 434 432 417 407 420 431 437 433 435 436
	  418 440 439 438 442 443 444 445 446 454 441 451 459 453 447 449 448 450 452 460 458 456 455 457 464 461 462 463 465 
	  476 467 466 402 383 495 496 514 498 497 485 487 481 480 479 491 490 489 493 494 483 478 482 484 486 499 488 500 501 502
	  133 135 134 172 141 171 183 184 170 143 147 144 148 149 152 136 140 137 138 139 142 145 146 150 173 180 182 181 179 
	  175 174 176 177 178 191 192 190 195  196 197 200 194 193 198 189 188 201 202 185 186 187 207 151 156 155 154 153 
	  167 169 168 208 159 157 158 166 161 160 162 163 217 218 213 214 216 164 165 211 212 209 210 215 248 246 245 
	  247 244 243 249  255 390 256 254 250 253 251 252 240 239 242 241 238 199 227 226 229 228 231 232 230 233 234 
	  224 222 223 203 225 206 205 204 221 219 236 235 237 220 1204 1205 1207 1209 1211 1208 1206 1210 1216 1217 1200 1198 1199 1202 1201
	  1203 1215 1221 1222 1228 1214 1213 1218 1219 1220 1227 1226 1225 1223 1231 510 492 512 513 511  507 509 506 505 475  
	  508 503 504 477 385 474 473 472 384 471 469 1772 1773 1205 1770 1769 1771 1774 1742 1743 1744 1745 1746 1768 1766 1775 1778 1796
	  1752 1749 1751 1763 1765 1780 1776 1777 1779 1867 1802 1804 1805 1797 1803 1851 1852 1853 1854 1860 1850 1849 1859 1856 1857
	  1808 1801 1807 1845 1843 1800 1798 1799 1806 1841 1748 1750 1747 1753 1757 1754 1756 1755 1782 1781 1810 1813 1814 1815 1816
	  1811 1809 1812 1829 1786 1785 1789 1790 1791 1818 1817 1819 1820 1825 1822 1821 1823 1824 1826 1784 1792 1783 1787 1793
	  1760 1758 1759 1764 1761 1788 1795 1762 1767 1794 1834 1830 1832 1839 1840 1835 1833 1831 1837 1836 1838 1842 1844 1870 1878
	  1862 1847 1858 1863 1882 1879 1846 1848 1881 1884 1873 1874 1875 1871 1869 1877 1872 1868 1876 1880  1892 1893 1888 1889 1891 
	  1887 1886 1890 1883 1885 1906 1907 1910 1909 1903 1865 1864 1866 1855 1861 1904 1902 1905 1908 324 322 326 323 325 
	  319 321 320 311 318 309 310 312 301 313 316 317 314 315 305 307 308 304 302 284 303 306 279 277 278 280 281 
	  282 286 287 283 285 295 296 297 294 293 298 300 299 288 292 2114 291 290 289 328 329 330 332 327 334 333 335 336 337
	  331 339 338 342 343 346 347 344 345 340 341 348 349 
	 360 361 364 363 350 359 362 358 356 355 352 353 354 357 351 1165 1166 1167 1172 1171 1158 1163 1164 1170 1157 1169 1173 1168 1159
	 1152 1155 1150 1149 1148 1156 1160 1153 1154 1151 1146 1144 1142 1140 1141 1143 1145 1147 1184 1186 1194 1138 1195 1196 1193
	 1175 1176 1244 1243 1177 1235 1174 1229 1230 1234 1241 1242 1245 1236 1238 1239 1240 1237 1232 1233 1914 1915 1912 1913
	 1246 1247 1248 1178 1180 1182 1179 1181 1185 1187 1086 1087 1085 1084 2115 1081 1082 1080 1079 1083 1089 1088 1091 1112 1113 1077 1078 1076 1115 1116 1117 1111 1114 1122  
	 1110 1120 1118 1124 1092 1090 1105 1093 1109 1096 1097 1098 1100 1095 1103 1102 1099 1107 1104 1094 1101 1106 1108 1126 1125 1121 1119 1189 1188 1183 1190 1191 1192
	 1123 1127 1128 1129 1134 1135 1132 1133 1131 1936 1931 1933 1935 1939 1943 1942 1938 1945 1944  1941 1946 1940 1957 1958 1934 1937 1950 1951 1932 1949 1952 1926 1925 1922
	 1953 1956 1959 1960 1954 1916 1918 1923 1917 1955 1965 1967 1966 1924 1948 1961 1962 1968 1047 1046 1136 1139 1137 1039 1044 1045 1043 1038 1040 1042 1048 1050 1049 1056 1055 1053
	 1063 1061 1060 1064 1073 1065 1072 1075 1074 1066 1067 1068 1069 1070 1071 1029 1032 1054 1052 1028 1035 1036 1037 1034  1030 1027 1026 1021 1031 1062 1025 1024 1023
     967 1022 969 968 1033 1017 1016 1018 1019 1014 1015 1020 1012 1011 1013 1041 963 966 965 964 962 959 960 961 958  945 955 956 957 938 953 939 940 937 933 931 932 954 930
	 936 935 934 941 944 943 946 948 947 950 951 952 949 942 972 971 970 983 973 974 975 984 999 989 991 990 988 987 986 985 979 980 981 977 976 978 982 992 993 994
	 995 996 997 998 1005 1004 1006 1007 1002 1003 1001 1000 1894 1895 1896 1897 1920 1900 1901 1899 2030 2031 2023 2026 1970 2028 2027 2024 1898 2025 1969 1911
	 1964 2018 1963 2017 2016 1984 1947 2014 2015  1988 1986 1985 1987 1990 1989 2019 1976 1991 2037 1992 1993 2008 3230 1996 1997 1995 1994 2006 2005 1998 1999 3231 2007
	 2004 2003 2002 2001 2000 1978 1977 2034 2035 2033 1973 1975 1979 1980 2029 1972 2021 2022 2020 1974 1971 2040 2043 2042 2036 2041 2046 2047 2048 2049
	 2053 2054 2052 2057 2051 2062 2061 2060 2055 2063 1981 2009 2039 2038 2045 2013 2012 2011 2010 2044 1982 2056 2050 2059 2058

}

africa = {
	612 615 616 617 613
	608 607 609 614 610
	619 618 620 623 622
	629 625 621 627 626
	1249 1250 630 637
	597 606 588 582 579
	589 598 599 583 605
	603 604 610 611 600
	624 601 602 591 586
	590 593 592 585 573 
	580 577 581 584 587
	716 717 715 718 719
	712 711 1641 1640 1639
	725 726 724 723
	720 721 722 710 708 
	707 709 706 704
	701 705 702 703 700
	698 699 697 695 696
	660 663 658 659 713
	661 666 656 657 662
	650 652 654 694 
	649 648 646 638 636
	651 653 655 665 647
	641 645 644 642 664
	639 640 628 643
	678 677 679 796 906
	675 674 676 686 685
	570 576 574 571 569
	560 563 564 561 558
	566 594 595 565 572
	567 568 575 578 562
	557 559 554 519 552
	521 550 522 517 518
	553 556 596 555 551
	523 516 515 524 525
	526 527 528 529 545
	541 540 542 543 536
	689 690 691 692
	549 548 547 
	632 633 634 635 539
	535 537 631 538 532
	534 533 530 531 544
	693 925 924 923
	738 741 
	744 740 739
	734 736 737
	735 729 730
	728 732 733 727 
	745 731 746 
	747 748 750 752 751
	743 749 742 770 
	754 753 2249 756 755
	760 757 758 761 759 
	762 763 780 781
	785 783 795 782
	787 786 788 789 790 
	792 791 793 794 3229
	778 777 779 776 775
	784 774 764 766 765
	772 773 767 768 769
	803 804 801 802 805
	807 808 806 809 811
	812 810 813 815 814
	821 818 817 819 816
	830 820 829 828
	823 822 824 825 826
	848 849 844 845 846
	839 841 843 840 842
	827 831 832 833 847
	856 855 834 835 836
	868 867 866 869 864
	872 838 837 929 896 
	870 871 873 874 875
	876 877 879 881 880
	892 884 882 883 894 
	885 878 886 887
	890 889 888 893 891
	895 897 898
	863 901 865 862 904
	858 857 861 860 859
	905 909 915 910 913
	912 914 911 916 917
	681 680 682 683
	919 918 920 921 922

}

asia = {
	2253 2252 2251
	2255 2254 2259 2258 2256
	2266 2267 2260 2261 2257
	2529 2533 2534 2532 2530
	2265 2262 2264 2276 2263
	2280 2282 2281 2275
	2296 2291 2524 2297
	2520 2521 2522 2545 2546
	2519 2528 2523 2579 2580
	2540 2536 2531 2547 2548
	2538 2535 2537 2539 2714
	2543 2544 2542 2541 2550
	2552 2553 2549 2551 2555
	2573 2564 2574 2575 2577
	2587 2576 2578 2630 2629
	2581 2580 2589 2588 2582
	2583 2582 2584 2586 2585
	2650 2649 2651 2648 2646
	2639 2644 2647 2642 2637
	2640 2641 2645 2643 2638
	2634 2635 2636 2633 2632
	2603 2604 2625 2602 2601
	2622 2628 2623 2626 2621
	2613 1620 2619 2627 2600
	2611 2614 2612 2605 2620
	2617 2598 2599 2597 2595
	2616 2618 2615 2596 2594
	2610 2624 2609 2593 2592
	2607 2608 2606 2572 2567
	2562 2568 2569 2570 2561
	2557 2556 2554 2558 2559
	2565 2563 2560 2566 2571
	2118 2119 2117 2143 2144
	2123 2122 2121 2120 2157
	2127 2126 2125 2124 2160
	2129 2128 2130 2131 2162
	2133 2132 2134 2166 2135
	2146 2147 2148 2153 2179
	2158 2155 2156 2159 2178
	2164 2163 2165 2169 2170
	2174 2168 2136 2137 2167
	2171 2172 2205 2201 2204
	2176 2173 2175 2177 2199
	2333 2332 2335 2337 2338
	2334 2209 2207 2206 2336
	2210 2200 2202 2203 2208
	2211 2212 2198 2213 2214
	2145 2116 2149 2150 2151
	2195 2194 2190 2189 2191
	2192 2197 2196 2193 2219
	2216 2215 2217 2222 2220
	2218 2244 2243 2340 2244
	2342 2344 2343 2339 2378
	2380 2382 2381 2341 2246
	3209 3208 3210 3211
	3215 3214 3216 3212 3213
	2234 2233 2235 2236 2245
	2230 2231 2232 2229 2228 
	2242 2237 2238 2221 
	2224 2226 2184 2185 
	2187 2186 2188 2154
	2180 2161 2152 2182
	2225 2227 2223 2183
	2279 2273 2270 2285
	2277 2278 2284 2283
	2286 2290 2289 2288 2287
	2274 2272 2271 2269 2268
	2299 2300 2316 2317 2320
	2295 2298 2293 2292
	2304 2301 2307 2310
	2302 2303 2306 2308 2311
	2294 2525 2526 2309 2312
	2313 2323 2314 2324 2351
	2318 2319 2325 2326
	2348 2331 2346 2349 
	2347 2350 2352 2369 2368
	2322 2321 2328 2329
	2371 2345 2377 2370
	2372 2376 2373 2374
	2471 2387 2384 2474 2475
	2470 2375 2472 2473
	2366 2367 2364 2353 2354
	2476 2477 2478 2481 2482
	2362 2363 2356 2357 2358
	2360 2361 3228 2498 
	2491 2479 3227 2480 
	2486 2483 2493 2484 2485
	2497 2488 2489 2653
	2500 2499 2652 2502 
	2503 2504 2501 2507
	2509 2508 2506 2505
	2514 2511 2510 2513 2359
	2516 2518 2517 2515 2512
	2666 2667 2670 2668 2669
	2665 2664 2673 2677 2678
	2674 2672 2671 2675 2676
	2660 2662 2661 2654
	2656 2657 2658 2659 2663
	2490 2487 2655 2492
	2068 2070 2071 2069 2067
	2066 2096 2095 2076 
	2077 2079 2093 2097 
	2074 2073 2072 2078 2080
	2082 2081 2083 2084 2085
	2102 2101 2100 2105 2091
	2090 3232 2092 2089 2103
	2107 2098 2109 2099
	2110 2104 2111 2108
	2106 2904 2905 2903 2907
	2901 2909 2910 2902 2908
	2881 2887 2882 2885 2888
	1983 2094 2065 2064
	2841 2883 2751 2884 2838
	2388 2385 2393 2421 2386
	2391 2389 2392 2395 2394
	2410 2396 2408 2409 2411
	2413 2424 2420 2416 2412
	2407 2400 2401 2402 2404
	2415 2414 2449 2456 2447
	2422 2423 2426 2427 2424
	2432 2429 2428 2434 2433
	2435 2436 2442 2431 2430 
	2438 2437 2075 2439 2440
	2444 2425 2441 2443 2445
	2446 2448 2451 2452 2453
	2454 2450 2457 2455 2458
	2463 2461 2462 2460 2459
	2464 2406 2405 2403 2465
	2468 2467 2466 2469
	2397 2693 2692 2398
	2694 2695 2697 2696
	2700 2699 2702 2703
	2688 2690 2691 2698 2701
	2704 2730 2731 2705
	2687 2689 2732 2686
	2735 2736 2734 2740 2712
	2682 2683 2684 2685 
	3224 2737 2679 2680 2738
	2711 2710 2739 2713 2717
	2708 2716 2709 2681 2733
	2772 2718 2773 2782 2748
	2715 2747 2727 2750 2742
	2744 2743 2741 2761 2815
	2706 2729 2722 2728
	2720 2719 2723 2721 
	2746 2745 2726 2725 2724
	2749 2771 2770 2762
	2791 2813 2814 2778 2787
	2777 2776 2775 2792
	2793 2794 2795 2790 2789
	2788 2786 2785 2812 2801
	2767 2780 2781 2779 2769
	2765 2839 2763 2766 2764
	2783 2768 2816 2784 2817
	2802 2811 2803 2804 2818
	2848 2840 2842 2837 2836
	2835 2845 2846 2834 2833
	2828 2832 2830 2826
	2819 2820 2821 2831 2806
	2824 2827 2825 2829
	2875 2878 2877 2876 2880
	2868 2874 2873 2872 2862
	2857 2856 2860 2858 2859
	2864 2869 2865 2861
	2866 2871 2863 2867 2870
	2891 2894 2893 2895 2896
	2892 2890 2889 2911 2897
	2900 2886 2879 2899 2898

}

china = {
	
}

india = {
	2949 2805 2953 2954 2823 2931 2822 2932 2935
	2930 2933 2943 2934 2927 2941 2942 2938 2944 2928 2929 2922 2924 2946 2945 2936 2947 2960 2939 2951 2940 2937 2969 2961 2962 2971 2970
	2968 2963 2967 2972 2964 2975 2973 2974 2977 2980 2979 2976 2978 2981 2983  2987 2988 2990 2995 2999 2991 2989 2986 2994 2992 2985 2982 2984 3006 3007
	2997 2996 3000 2998 2993 3001 3003 3002 3004 3005 3008 3009 3010 3011 3013 3017 3016 3015 3014 3012 3026 3024 3023 3020 3029 3027 3025 3028 3041 3042
	3043 3072 3073 3077 3078  3084 3085 3188 3083 3086 3079 3082 3081 3080 2956 2914 2912 2913 2923 2921 2957 2958 2955 3098 2948 2915 2916 2917
	2920 2918 2919 3102 3099 2959 2965 2952 2926 2966 3183 3184 3182 3181 3180 3095 3092 3093 3094 3096 3089 3100 3097 3103 3088 3101 3091 3090 3087 
	3107 3110 3111 3108 3113 3109 3114 3115 3187 3186 3179 3178 3128 3127 3119 3118 3116 3117 3058  3069 3068 3070 3071 3075
	3106 3104 3105 3076 3189 3019 3018 3021 3022 3033 3030 3039 3038 3031 3032 3065 3034 3036 3037 3035 3044 3045 3046 3047 3049
	3051 3050 3052 3054 3055 3064 3062 3059 3066 3067 3060 3061 3057 3056 3185 3190 3120 3053 3121 3137 3122 3124 3123 3126 3125
	3176 3177 3175 3174 3131 3136 3149 3138 3191 3135 3130 3150 3134 3133 3152 3194 3193 3197 3195 3196
	3198 3206 3205 3204 3202 3203 3200 3201 3199 3159 3161 3160 3158 3063 3164 3165 3166 3162 3163 3144 3192 3146 3145 3142
	3140 3141 3143 3139 6 3157 3168 3147 3153 3132 3151 3148 3169 3167 3170 3172 3173

}

wasteland_continent = {
	257 258 259 260 261 262 263 264 265 266 267 268 269 270 271 272 273 274 275 276 375 520 546
	667 668 669 670 671 672 673 684 687 688 714 771 797 798 799 800 850 851 852 853 854 899 900
	902 903 907 908 926 927 928 1008 1009 1010 1051 1057 1058 1059 1130 1161 1162 1197 1224 1827
	1828 1921 1927 1928 1929 1930 2032 2086 2087 2088 2112 2113 2138 2139 2140 2141 2142 2181
	2241 2240 2239 2247 2248 2250 2305 2315 2327 2330 2355 2365 2379 2383 2390 2399 2417 2418
	2419 2494 2495 2496 2527 2590 2591 2631 2752 2753 2754 2755 2756 2757 2758 2759 2760 2774
	2796 2797 2798 2799 2800 2807 2808 2809 2810 2843 2844 2847 2849 2850 2851 2852 2853 2854
	2855 2906 2925 2950 3040 3048 3112 3129 3154 3171 3155 3207 3217 3218 3219 3220 3221 3222
	3223 3225 3226 3233
	# Water Wasteland
	1593 1595 1596 1599 1600 1602 1608 1609 1610 1613 1625 1628 1630 1631 1632 1633 1634 1635 
	1636 1637 1638 1919 1651 1652
}	


island_check_provinces = {
}

new_world = {
}