#Example: Large parts of Africa and south east Asia
tropical = {
			3184 3183 3182 3181 3180 3179 3178 3177 3176 3175 3173 3172 3170 3169 3168 3167 3166
			3165 3164 3162 3163 3161 3159 3063 3144 3192 3142 3141 3143 3145 3139 3140 3138 3136 
			3135 3191 3121 3190 3120 3185 3118 3058 3117 3186 3059 3057 3060 3054 3056 3053
			3052 3061 3055 3051 3050 3049 3046 3047 3062 3045 3044 3065 3064 3066 3038 3037
			3034 3035 3036 3032 3033 3031 3022 3019 3021 3018 3009 3008 3010 3193 3194 3198 3205
			3206 3204 3203 3197 921 922 923
}

arid = {
	632 633 634 635 539 535 537 631 538 532 541 540 542 543 536 544 545 551 553 556 596 555 552
	566 594 595 565 572 558 561 564 574 581 590 593 592 585 573 591 586 584 601 602 627 629 637
	716 717 715 718 719 712 711 1641 1640 1639 725 726 724 723 720 721 722 710 708 698 699 697 695 696
	660 663 658 659 713 661 666 656 657 662 650 652 654 694 649 648 646 638 636 651 653 655 665 647
	641 645 644 642 664 639 640 628 643 678 677 679 796 906 675 674 676 686 685 693 689 690 691 692
	700 703 702 727 733 787 786 788 789 790  792 791 793 794 3229 749 743 2252 2251 770 
	754 753 2249 756 755 760 757 758 761 759 762 763 780 781 785 783 795 782 778 777 779 776 775
	784 774 764 766 765 772 773 767 768 769 803 804 801 802 805 807 808 806 809 811 812 810 813 815 814
	821 818 817 819 816 830 820 829 828 823 822 824 825 826 848 849 844 845 846 839 841 843 840 842 
	831 827 855 834 835 836 837 929 838 860 861 847 832 833 2255 2254 2259 2258 2256 2266 2267 2260 2261 2257
	2529 2533 2534 2532 2530 2265 2262 2264 2276 2263 2270 2269 2268 2271 2272 2274 2275 2281 2296 2291 2524 2297
	2520 2521 2522 2545 2546 2519 2528 2523 2579 2580 2540 2536 2531 2547 2548 2538 2535 2537 2539 2714 
	2543 2544 2542 2541 2550 2552 2553 2549 2551 2555 2248 2525 2526 2303 2314 2311 2324 2313 2323 2351 2352 
	2366 2367 2364 2353 2354 2374 2480 3227 3228 2361 2360 2362 2363 2356 2357 2358 2514 2511 2510 2513 2359
	2517 2515 2512 2573 2564 2574 2575 2577 2587 2576 2578 2630 2629 2581 2589 2588 2583 2582 2584 2586 2585
	2650 2649 2651 2648 2646 2639 2644 2647 2642 2637 2640 2641 2645 2643 2638 2634 2635 2636 2633 2632 2603 2604 2625 2602 2601
	2622 2628 2623 2626 2621 2619 2613 2611 2612 2605 2620 2609 2607 2608 2606 2572 2567 2562 2568 2569 2570 2561 
	2557 2556 2554 2558 2559 2565 2563 2560
	2739 2717 2715 2747 2727 2750 2742 2744 2743 2741 2761 2815 2712 2740 2731 2730 2722 2745 2729 2706 2728
	2704 2746 2726 2749 2771 2770 2762 2791 2813 2814 2778 2787 2772 2718 2773 2782 2748 2767 2780 2781 2779 2769
	2777 2776 2775 2792 2789 2790 2793 2795 2788 2786 2785 2812 2783 2768 2816 2784 2803 2804 2766 2763 2764 2838
	2884 2881 2887 2882 2885 2888 2901 2902 2886 2899 2870 2867 2889 2837 2836 2834 2833 2868 2874 2923 2955 2926 2952  
	892 894 893 891 890 889 887 886 884 2312 2309 2270 2269 2273 2294 888 895 1162 1161
}  

arctic = {

}

mild_winter = {
	355 356 358 354 353 352 351 350 303 304 277 278 279 280 281 283 284 282 286 287 289 290 291 292 2114
	1819 1818 1817 1814 1815 1816 1810 1813 1809 1781 1754 1753 1750 1748 1747 1744 1745 1743 1742 1746
	490 491 494 493 489 486 484 483 482 478 455 457 448 450 449 456 458 447 452 444 445 443 442 441 446 
	242 241 239 221 204 222 203 223 227 228 231 233 201 198 187 207 167 212 165 211 214 216 245 246 215
	248 251 396 398 399 372 371 366 98 101 102 103 104 88 89 107 114 108 87 84 65 76 64 61 54 46 40 36 
	30 27 122 266 123 126 125 127 118 1167 1164 1163 1157 1158 1156 1150 1147 1142 1046 1043 1040 1037 
	1009 1029 1032 1027 1061 1072 1018 1014 968 1021 947 948 946 943 1111 1117 1112 1091 1092 1938 1943
	1106 1107 1103 1104 1105 1945 1102 1099 1984 1098 2229 2228 2227 2225 2223 2183 2182 2180 2196 2192
	2219 2213 2214 2210 2211 2189 2194 2195 2198 2177 2173 2168 2174 2176 2201 2204 2209 2336 2338 2167
	2701 2757 2704 2705 2730 2729 2706 2728 2760 2751 2724 2725 2755 2732 2735 2734 2683 2682 2685 2496 
	2708 2492 2654 2660 2662 2664 2327 2197 2212 2858 2827 2824 2861 2865 2853 2892 2890 2911 2910 2909
	2908 2907 2905 2107 1983 2098 2094 2099 2100 2093 2101 2102 2091 2090 2092 3232 451 453 454 459 435 
	433 431 437 436 439 440 438 420 419 406 415 267 2056 2050 2044 2045 2038 2039 1981 3230 2035 2033 
	2034 1977 1978 1974 1972 2020 2018 1964 2016 2017 2019 2007 3231 2005 1998 1999 1997 2816 2806 2823
	2932 2935 2940 2831 2810 2826 62 418 417 407 408 414 413 2466 2468 2465 2403 1976 2037 2006 2008
	2009 2010 2011 2012 2013 83 86 97 93 58 41 3212 
} 

normal_winter = {
	2906 1834 1830 1832 1839 1840 1835 1833 1831 1837 1836 1838 1842 1844 1870 1878 1862 1847 1858 1863 1882
	1879 1846 1848 1881 1884 1873 1874 1875 1871 1869 1877 1872 1868 1876 1880 1892 1893 1888 1889 1891 
	1887 1886 1890 1883 1885 1910 1909 1903 1865 1864 1866 1855 1861 1904 1902 1905 1908 1894 1895 1896 1897 1920 
	1900 1901 1899 2030 2031 2023 2026 1970 2028 2027 2024 1898 2025 1969 1911 1973 1975 1979 1980 2029
	1971 2040 2043 2042 2036 2041 2046 2047 2048 2049 2053 2054 2052 2057 2051 2062 2061 2060 2055 2063
	1786 1785 1789 1790 1791 1768 1766 1775 1778 1796 1752 1749 1751 1763 1765 1780 1776 1777 1779 1867
	1802 1804 1805 1797 1803 1851 1852 1853 1854 1860 1850 1849 1859 1856 1857 1808 1801 1807 1845 1843
	1800 1798 1799 1806 1841 1760 1758 1759 1764 1761 1784 1792 1783 1787 1793 1760 1758 1759 1764 1761
	1788 1795 1762 1767 1794 510 492 512 513 511 507 509 506 505 475 508 503 504 477 1770 1769 1771 1774
	495 496 514 498 497 499 488 500 501 502 485 487 481 480 479 476 467 466 402 383 464 461 462 463 465
	428 429 434 432 424 426 427 430 422 423 397 403 425 400 392 393 391 395 394 416 410 409 411 412 271 
	324 322 326 323 325 319 321 320 311 318 309 310 312 301 313 316 317 314 315 328 329 330 332 327 
	334 333 335 336 337 331 339 338 342 343 346 347 344 345 340 341 348 349 362 363 364 361 359 357 360 
	307 308 305 306 302 285 293 298 300 299 288 295 296 297 294 365 95 96 99 110 105 106 113 117 119 2064
	1198 1200 1201 1175 1176 1244 1243 1177 1235 1174 1229 1230 1234 1241 1242 1245 1236 1238 1239 1240 1237 1232 1233
	1914 1915 1912 1913 1246 1247 1248 1178 1180 1182 1179 1181 1185 1187 1172 1173 1169 1168 1159 1160 1153 1154 1151 
	1184 1186 1145 1143 1194 1138 1195 1196 1193 1141 1188 1183 1190 1191 1192 1123 1127 1128 1129 1134 1135 1132 1133 
	1131 1126 1125 1121 1119 1189 1110 1120 1118 1124 1116 1115 1122 1109 1108 1916 1918 1923 1917 1936 1931 1933 1935 
	1939 1942 1944 1050 1049 1056 1055 1053 81 77 63 55 49 50 47 44 247 252 256 249 244 243 240 262 217 213 218 208 261
	202 205 206 260 219 220 237 224 225 264 263 232 234 235 236 238 132 131 2073 2074 2433 2434 2432 2437 2435 2436 2438 
	2429 2428 2233 2234 2235 2242 2245 2380 2381 2341 2378 2385 2388 2393 2392 2391 2390 2394 2395 2396 2397 2692 2343 
	2342 2340 2142 2330 2244 2246 2238 2221 2193 2185 2191 2188 2187 2186 2184 2224 2226 2216 2215 2217 2208 2203 2202 
	2200 2199 2693 2694 2696 2494 2691 2698 2690 2688 2689 2687 2495 2686 2736 2684 2678 2673 2661 2444 2446 2447 2448
	2453 2450 2457 2454 2458 2460 2462 2461 2463 2459 2406 2407 2404 2405 2464 2467 2089 2402 2699 2700 2702 2703 2719 
	2720 2758 1757 2723 2759 2893 2894 2891 2430 2218 2222 2243 2220 2237 2236 2232 2231 2230 2181 2141 2140 2138 2139
	2021 2022 1963 2015 2014 1947 1946 1940 1937 1925 1934 1932 1922 1926 1949 1952 1924 1965 1955 1954 1953 1956 1214 
	1213 1218 1219 1220 1208 1206 1210 1216 1217 1204 1205 1207 1209 1211 1223 1225 1226 1227 471 469 1772 1773 1205
	385 474 473 472 384 377 380 381 382 376 401 421 404 405 460 1756 1755 1782 1811 1812 1829 1812 1821 1822 1820 1825 
	1197 1059 1058 1057 1130 1073 1075 1064 1060 1051 1010 1137 1048 1042 1038 1034 1028 1052 1054 1020 1019 1008 2389
	2860 2859 2825 2820 2807 2800 2819 2821 2822 2849 2974 3017 1161 1162 1982 2059 2058 270 
} 

severe_winter = {
	1823 1824 1826 1907 1906 1966 1967 1968 1962 1960 1959 1958 1957 1961 1948 1941 1950 1951 
	373 370 374 378 379 100 111 112 470 468 115 1212 1215 1199 1202 1221 1203 1222 1228 1231
	2426 2427 2425 2424 2422 2423 2386 2382 2421 2414 2409 2456 2408 2398 2412 2413 2420 2416
	2411 2410 2400 2697 2695 2401 2080 2075 2439 2440 2441 2443 2445 2451 2452 2455 2469 2085 
	2084 2083 2082 2081 2896 2895 265 272 375 273 274 275 276 1224 1930 1929 1928 1927 2239 
	2240 2241 2379 2383 2419 2418 2417 2399 2088 2087 2086 2756 2855 2844 2843 2950 2415 2449
	1827 1828 1921 2032 2112 2113 2999 2995 2990 2987 2988 2971 2962 2808 2809 2431 2442
}

impassable = {
	257 258 259 260 261 262 263 264 265 266 267 268 269 270 271 272 273 274 275 276 375 520 546
	667 668 669 670 671 672 673 684 687 688 714 771 797 798 799 800 850 851 852 853 854 899 900
	902 903 907 908 926 927 928 1008 1009 1010 1051 1057 1058 1059 1130 1161 1162 1197 1224 1827
	1828 1921 1927 1928 1929 1930 2032 2086 2087 2088 2112 2113 2138 2139 2140 2141 2142 2181
	2241 2240 2239 2247 2248 2250 2305 2315 2327 2330 2355 2365 2379 2383 2390 2399 2417 2418
	2419 2494 2495 2496 2527 2590 2591 2631 2752 2753 2754 2755 2756 2757 2758 2759 2760 2774
	2796 2797 2798 2799 2800 2807 2808 2809 2810 2843 2844 2847 2849 2850 2851 2852 2853 2854
	2855 2906 2925 2950 3040 3048 3112 3129 3154 3171 3155 3207 3217 3218 3219 3220 3221 3222
	3223 3225 3226 3233 3236 3234 3235
	# Water Wasteland
	1593 1595 1596 1599 1600 1602 1608 1609 1610 1613 1625 1628 1630 1631 1632 1633 1634 1635 
	1636 1637 1638 1919 1651 1652 1653 1654 1655 1656
}
