#Example: Large parts of Africa and south east Asia
tropical = {
			3064 3065 3066 3067 3068 3069 3070
			3071 3072 3073 3255 3256 3257 3258 
			3259
			
			3340 3343 3345 3286 3287 3293 3295 3296 3298 3299 3301
			3302 3303 3305 3304 3306 3309 3310 3311 3315 3319 3318 
			3320 3321 3322 3325 3326 3327 3328 3329 3330 3331 3332
			3333 3334 3336 3337 3338 3339 3284 3335 3272 3273 3270 
			3271 
			
			3393 3390 3389 3378 3371 3370 3400 3401 3015 3395 3396
			3397 3398 3399 3402 3403 3404 3405 3406 3407 3408 3409
			3414 3415 3417 3416 3418 3392
			
			3733 3734 3735 3736 3737 3738 3739 3740 3741 3742 3743 3744 3745 3746 3747 3748 3749 3750 3751 3752 3753 3754 3755 3756 3757 3758 3759 3760 3761 3762 3763 3764 3765 
}

arid = {
	3136 3135 3141 3142 1237
	3240 3241 3244 3242 3145 3146 3144 3143
	3248 3247 3246 3245 3249 3243
	446 447 445 3194 3193 3192 432 431 
	3191 3190 2342 3183 3182 3180 2478 1746 1747 3181 2476 2477 
	2472 2473 2474 2475 3179 3177 485 3187 3186 3185 3189 3188 3184
	490 491 492 3106 493 417 418 419 420 489 487 2439 3104 3103 3102
	3178 3108 3175 3174 3176 494 3173 3170 3171 3172 3169 3167 3168 3107
	3165 1744 3166 3162 3161 3164 3163 3160 1745 3101 1743 3100 1751 1748 1750
	3156 3155 3157 2343 3158 3159 3195 3197 3196 3199 3198 3201 2480 3200 2479 3203 2481 3202
	2504 2505 2506 2507 2508 2509 2510 2511 2512 3219 3204 2513 2514 2515 2516 2517 2518 2519 3221 3220
	2520 2521 2522 2523 3224 3223 3222 3215 2565 3096 2566 3097 2567 2564 3211 2563
	3216 3217 2526 2527 2528 3212 3218 3213 2568 2370 2371 3091 2372 3205 3095 3094 3093
	2368 2367 2365 2366 2369 3110 3109 3154 3147 3148 3149 3150 3151 3152 3153 2463 2464
	3032 3112 3237 3238 1778 2373 3034 3239 1775 1777 1776 1779 1787 2374 2336 2332 2335 3033 3035 3111
	2334 2333 3113 1789 3114 2331 2432 2340 2338 2433 2339 2337 3116 3115 3117 2341 
	3118 3119 2570 2434 2435 2431 2593 2596 2594 2595 2573 2576 2575 2578 2572 2577 2579
	2574 2571 1289 723 1253 1254 1255 1256
	2588 2587 2592 2589 2590 2591 3051 3050 3049 3048 3044 3047 3046 3045 2424 2428
	2427 2426 2430 2429 2425 1937 1934 3030 3123 3039 1799 3038 3036 3037 1821 3040 3025 3278 2044 
	2045 2049 2040 2054 2056 2057 2060 2058 2059 2035 2036 2051 2052 2053 2055 2039 2072 2069 2066
	2632 2627 2625 2633 2634 2628 2643 2644 2326 2327 2325 2322 2395 2324 2318 2317 2315 2418 2419
	2417 2446 3208 3207 3209 3206 2562 3092 3210 3437 3436 3433
	3616 3617 3618 3619 3620 3621 3622 3623 3624 3625 3626 3627 3628 3629 3630 3631 3632 3633 3634 3635 3636
	3693 3694 3695 3696 3697 3698 3699 3700 3701 3702 3730 3 3530 299 381 391 430 435 436 458 442 468 462
	
}  

arctic = {

}

#Example: Most of Europe north of med.
mild_winter = {
		78 79 81 85 84 86 90 93 94 95 96 98 110 114 115 2171 191 707 704 701 696 694 697 688 660 826 827 844 845 846 847 849 857 850 852 853 854 1847 1174 1177 1176 2301 2302 1189 1169 1165
		1166 1167 1138 1141 1142 1143 1157 1139 1164 1170 1140 1190 1188 1203 689 658 655 661 663 666 665 642 643 671 679 680 681 682 1096 1097 1108 1120 1124 1114 1115 1116 1145
		1100 
		1006 685 686 676 667 668 710 702 1196 1973
		842 843 1842 858 859 1099 1098 1146 1147 1144 1158 1159 1160 1163 1161 1205
		2445 2449 2446 2447 3022 2788 2170 2201 2202 2208 89 91 100 97 
		619 599 598 579 580 621 649
		2404 2402 2403 2405 2406 3055 3056 2410 2412 2411  
		1219 1220 1222 1225 2155 2133 2134 2135 2136 2137 2138 2140 2141 2142 2230 2233 2229 2228 2223 2224 2225 2226 2221 2220 2211 2209 2207 2206 2205 109 117 99 105 106 116 119
		2178 2176 2175 2174 2173 2172 2168 2169 2166 2165 2164 2163 2162 2161 2160 2159 283 183 181 182 199 200 185 186 189 190 196 192 193 203 210 212 213 222 280 219 279 208
		206 278 276 202 201 709 708 703 700 699 269 2602 2407 2047 2048 1971 1968 1969 1967 1965 1972 1974 2003 1863 1856 2296 648 3274 
		
		3483 3484 3486 3489 3482 3481 3480 2875 2873 2872 2871 2863 2862 2861 2866 2864 2854 2855 2856 2857 2858 
		2882 2939 2934 2884 2881 2880 2883 2889 2942 2941 2940 2891 2890 2888 3020 2960 2957 2958 2961 3352 3354 
		3353 3384 3364 3377 3362 3363 3365 3355 2943 2879 2878 2870 3356 3074 3582 3583 3584 803 3592
		
		270 273 287 272 288 274 286 76 83 82 88 87 102 103 101 131 104 129 118 120 127 125 126 618 602 
		617 624 662 623 614 664 589 535 531 538 825 824 822 828 848 841 839 840 838 805 1855 3608 3609
		3726 1857 2299 2295 1948 2046 2392 2416 3639 2423 3090 294 295
		 
		
} 

#Example: Inland Europe & Scandinavia
normal_winter = {
	108 107 112 2198 2199 2196 2192 2186 2188 2190 2187 2254 2255 2243 2240 2246 2247 2248 2249 2250 2282 2260 2251 2252 2257 2253 2152 2151 2148 2150 1175 1178 1181 1182 1183 1179 1171 1172 
	1186 1187 1862 2306 2303 1860 1168 1230 1231 1232 1233 1234 1235 1236 1237 1238 1239 1240 1242 1243 1244 1245 1246 1247 1248 1249 2100 2101 2102 2103 2107 2108 2109 2110 2111 2112 2113 2114 2115
	2116 2117 2118 2119 2120 2121 2122 2123 2124 2127 2128 2129 2130 2131 1859 860 861 862 863 864 865 866 867 868 869 870 871 872 873 874 875 876 878 879 880 881 882 883 884 885 886 887
	888 889 890 891 892 893 894 895 896 897 898 899 900 901 902 903 904 905 906 907 912 913 914 915 916 917 918 919 920 921 922 923 924 925 926 927 928 929 930 931 932 933 934 935 936 937 938 939 940 941 
	942 943 944 945 946 947 948 949 950 951 952 953 954 955 956 957 958 959 960 961 962 963 964 965 966 967 968 969 970 971 972 973 974 975 977 978 979 980 981 982 983 984 985 986 987 988 989 990
	991 992 993 994 995 996 997 998 999 1000 1001 1002 1003 1004 1005 1008 1009 1012 1013  1017 1018 1019 1020 1021 1022 1023 1024 1025 1026 1027 1028 1029 1030 1031
	1032 1033 1034 1035 1036 1037 1038 1039 1040 1041 1042 1043 1044 1045 1046 1047 1048 1049 1050 1051 1052 1053 1054 1055 1056 1057 1058 1059 1060 1061 1062 1063 1064 1065 1066 1067 1068 1069 1070
	1071 1072 1073 1074 1075 1076 1077 1078 1079 1080 1081 1082 1083 1084 1085 1086 1087 1088 1089 1090 2256 2258 2259 2263 2264 2265 2261 2266 2262 2267 2268 2269 877 2270 2271 2272 2273 2274 2275 2276 
	2277 2278 2283 2284 2285 2288 187 188 1211 1212 1214 1215 2279 2280 2281 711 712 713 714 683 684 687 677 678 673 674 675 669 672 1210 1091 1092 1094 1095 1104 1107 1101 1102 1103 1193 1194 1109 1173
	851 855 715 1093 1105 1106 1110 1111 1112 1113 1130 1131 1132 1151 1154 1152 1153 1155 1156 1149 1148 2436 2443 2450 2451
	2486 2487 2488 2489 2490 2491 2492 2493 2494 2442 2770 2771 2772 2773 2774 2775 2776 2777 2778 2779 2780 2781 2782 2783 2784 2786 2787 2789 3004 3005 3006 3007 3008 3009 3010 2785
	2460 2461 1150 3042 3043 92 1943 1939 1945 2496 2459 2409 2408 3041 3054 2319 2311 2312 2313 2421
	184 1010 1015 282 175 178 179 1016 197 198 195 194 204 205 211 209 281 215 180
	2180 2181 2179 2195 2210 2183 2184 2185 111 113 2182 2191 2194 2203 2204 2177 
	1227 1221 1224 1229 1223 1228 1226 1241 2104 2105 2139 2156 2153 2154 2149 2146 2143 2144 2145 2147 2158 2106 2157
	2193 2197 2212 2213 2219 2222 2227 2200 2215 2217 2231 2232 2234 2216 2214 2218 2236 2237 2189 2242 2238 2244 2239 2241 2235 2245 2290 2291 2287 2289 2286 
	293 271 2601 2605 2041 1854 176 2791 2792 2793 3349 3350 3410 908 911 910 909
	# china
	2987 2986 2985 2988 3436 3438 3434 3437 3432 3433 3435 3439 3440 3441 3442 3494 2803 2804 2805 2806 2807 2808 3427 3428 3431 3430
	2916 2917 2918 2919 2920 2913 2915 2914 2911 2912 2910 2907 2797 2794 2795 2796 2799 2798 2800 2801 2906 2809 2905 2903 2904 2811 2802 2810 2908
	2816 3429 2813 2812 2898 2897 2814 2815 2900 2901 2902 2909 2899 2892 2896 2894 2895 2825 2826 2877 2885 2886 2893 2887
	2876 2874 2865 2828 2831 2830 2837 2838 2841 2843 2842 2834 2832 2818 2819 2820 2821 2835 2833 2823 2824 2827 2829 2817 2822
	2844 2849 2850 2851 3443 2846 2847 2848 2845 2836 3491 3487 3492 3478 3493 3485 3488 3490 3479 3477
	3475 3476 3474 3473 3470 3467 3444 3445 3446 3448 3462 3465 3472 3471 3468 3469 3466 3464 3463 3460 3459 3454 3455 3457 3456 3458 3453
	3450 3451 3461 3452 3496 3447 3449 3495 2839 2840 2860 2853 2852 2859 3261 3262 3263 3260 3358 3359 3360 3076 3357 3075 3383 3382 3376 3361 3387
	3002 3077 3078 3526 3527 3528 2500
	3535 3536 3537 3538 3539 3540 3541 3542 3543 3544 3545 3546 3547 3548 3549 3550 3551 3552 3553 3554 3555 3556 3557 3558 3559 3560 3561 3562 3563 3564 3565
	3568 3569 3570 3571 3572 3573 3574 3575 3576 3577 3578 3579 3580 3581 1213 3601 3604 3607
	
	654 620 622 650 653 656 3613 3637 3648 
	3661 3662 3663 3664 3665 3666 3667 3668 3669 3670 3671 3672 3673 3674 3675 3676 3677 3684 3685 3686 3687 3688 3689 3690 3691 3692 
	3703 3704 3705 3706 3707 3708 3709 3710 3711 3712 3713 3714 3715 3716 3717 3718 3719 3720 3721 3722 6 3724 3725 
	1970 3728 2499 1845 2293 2292 1844 2307 2309 1861 2297 1185 1184 1180 2298 1843 856 296 297
	1858 1849 1848 1846 1852 2304 2305 2308 1853 2300 2294 3031 1944 1947 1940 2042 1942 1949 1941 1946 3729
}

#Example: Russia & Lappland
severe_winter = {
	2132 2126 2125 1216 1217 1218 976 2453 2454 2455 2456 2457 2458 2790 3253 3254 1014 1011 177 1007 2444
	3346 3347 3348 3649 3650 3651 3652 3653 3654 3655 3656 3657 3658 3659 3660 3680 3681 3682 3683 3412 3003 3520
}

impassable = {
	257 258 259 260 261 262 263 264 265 266 267 268 269 270 271 272 273 274 275 276 375 520 546
	667 668 669 670 671 672 673 684 687 688 714 771 797 798 799 800 850 851 852 853 854 899 900
	902 903 907 908 926 927 928 1008 1009 1010 1051 1057 1058 1059 1130 1161 1162 1197 1224 1827
	1828 1921 1927 1928 1929 1930 2032 2086 2087 2088 2112 2113 2138 2139 2140 2141 2142 2181
	2241 2240 2239 2247 2248 2250 2305 2315 2327 2330
	
	# Water Wasteland
	1593 1595 1596 1599 1600 1602 1608 1609 1610 1613 1625 1628 1630 1631 1632 1633 1634 1635 1636 1637 1638 1919
}
