europe = {

}


north_america = {
	
}

south_america = {
	
}

oceania = {
	
}

###############

europe = {
		255 256 257 258 250 251 252 253 254 249 290 291 292 289 262 259 260 261 264 265 266 267 268 269 270 271 293 272 273 274 286 287 288
		548 549 550 551 552 553 554 555 556 557 726 727 728 729 543 544 545 546 547 561 562 563 564 565 566 567 597 2497 500 501 502 503 504 
		505 506 507 542 558 559 560 568 569 570 571 572 573 574 578 579 580 581 575 576 577 540 539 582 583 584 585 586 582 583 584 587 588 
		589 594 595 596 598 602 618 722 724 719 720 721 2498 590 591 592 599 600 619 644 593 645 646 647 648 649 601 603 616 617 620 654 
		624 623 614 653 622 621 604 605 606 607 608 609 610 241 242 243 244 245 246 247 248 1786 240 284 1780 1781 239  224 225 263 227 228 
		174 226 236 237 238 1782 285 233 1784 1783 214 216 217 218 219 220 221 222 223 210 211 212 213 215 281 280 209 208 205 204 203 200 201 
		202 275 206 207 277 279 276 278 197 198 194 195 196 192 193 199 181 182 183 283 282 1015 180 175 1010 1013 178 179 1009 176 1012 1011
		1016 184 185 186 189 187 190 188 1005 191 709 51 52 53 54 55 57 58 60 61 62 63 64 65 68 69 70 132 133 134 135 136 138 139 140 71 66 67 
		59 56 48 49 50 141 142 143 144 145 146 147 148 149 150 151 46 47 1 2 4 5 7 8 9 10 11 12 13 72 73 74 75 76 77 78 79 80 81 82 83 84 
		85 86 87 88 89 90 14 15 16 17 18 19 20 21 22 153 154 155 156 157 158 159 167 168 169 137 170 172 173 152 160 161 162 163 164 165 166
		23 24 25 33 34 35 36 37 38 39 40 41 42 43 122 123 124 115 32 128 127 129 171 125 126 118 119 120 116 114 121 130 131 102 103 100 104 
		105 106 98 99 91 92 93 94 95 96 110 111 113 117 109 97 101 2210 2212 2213 2200 2199 2197 2198 2196 2215 2216 2192 2195 2201 2202 2203 
		2204 2205 2206 2207 2208 2209 2211 2194 2169 2172 2173 2163 2164 2165 2159 2160 2161 2162 2168 2170 2171 2185 2191 2186 2188 2187 2184 
		2173 1014 2183 44 45 2166 2175 2176 2177 2178 2179 2180 2182 2167 2174 2181 26 27 28 29 30 31 2230 2231 2232 2233 2234 2217 2219 2218 
		2236 2237 2238 2214 2239 2220 2221 2222 2223 2224 2225 2226 2227 2228 2229 2240 2241 2242 2243 2193 2189 2254 2255 2190 2235 2244 2245 
		2246 2247 2248 2249 2290 2291 2289 2288 2283 2282 2250 2250 2251 2252 2260 2259 2257 2258 2261 2266 2281 2280 177 861 860 1008 866 867 
		869 865 878 880 879 877 863 864 868 876 870 875 871 872 872 873 885 2253 2256 862 2263 2264 2265 2267 2262 2270 2268 2269 2271 2272 2273 
		2274 2275 2277 2278 2276 2286 908 2284 2285 2287 2279 909 910 911 912 913 914 907 902 903 895 889 890 892 888 881 882 883 884 886 887 893 
		891 900 905 906 899 898 901 894 896 938 937 897 931 935 936 939 941 916 947 948 904 930 932 934 933 965 942 943 945 949 946 940 944 971 969 
		966 917 950 951 915 918 964 954 953 952 956 955 959 977 957 958 960 961 1017 1027 963 967 968 962 970 1030 1032 1031 1029 1028 1025 1018
		1019 1020 1021 1022 1023 1024 1026 1034 1035 1037 1036 1038 1033 1040 1211 1212 1213 1214 1215 2100 2101 2102 2103 2104 2105 2106 2107 2108 
		2109 2110 2111 2112 2113 2114 2115 2116 2117 2118 1244 1245 1246 1247 1248 2158 1249 1219 1220 1221 1222 1223 1224 1225 1226 1227 1228 1229 
		1230 1231 1232 1241 1240 1233 1234 1235 1236 1238 1239 1242 1243 2442 2133 2134 2135 2136 2137 2138 2139 2140 2141 2142 2143 2144 2145 2146 
		2147 2148 2149 2150 2151 2152 2153 2154 2155 2156 2157 2119 2120 2121 2122 2123 2124 2125 2126 2127 2128 2129 2130 2131 2132 919 920 921 922 
		923 924 925 926 927 928 929 972 973 974 975 978 979 980 981 984 983 982 988 989 987 994 990 993 995 992 986 985 991 1043 996 1039 997
		708 707 706 705 704 703 702 701 700 699 698 697 696 695 694 693 692 691 710 689 688 690 687 2437 999 1000 1004 874 1002 715 713 714 1003
		1044 1045 1046 1054 1041 1052 1053 998 712 711 1001 650 651 652 656 658 657 659 660 3274 662 663 655 661 664 666 667 676 685 686 677 683 684 
		678 675 674 673 672 671 670 679 680 681 682 1049 1050 1051 1073 1057 1060 1059 1055 1058 1056 1071 1072 1048 1047 1042 1070 1069 1065 1064 1063 
		1062 1061 627 640 641 628 665 642 643 668 669 634 633 632 635 636 637 638 639 631 630 629 613 612 615 625 626 611 717 716 718 1076 1075 1079 
		1082 1085 1086 1083 1084 1080 1081 1067 1066 1077 1078 1074 520 523 519 516 517 518 541 521 522 524 525 526 528 533 530 529 514 527 532 
		538 536 535 531 537 534 511 512 513 515 509 510 508 234 235 1785 231 232 230 229 217 3525
		3568 3569 3570 3571 3572 3573 3574 3575 3576 3577 3578 3579
		3703 3704 3705 3706 3707 3708 3709 3710 3711 3712 3713 3714 3715 3716 3717 3718 3719 3720 3721 3722
		
			
}

africa = {
		2501 2502 2503 2504 2505 2506 2507 2508 2509 2510 2511 2512 2513 2514 2515 2516 2517 2518 2519 2520 2521 2522 2523 2524 2525 2526 2527 3204
		3206 3207 3208 3209 3210 3215 3216 3217 3218 3219 3220 3221 3222 3223 3224 2528 2529 2530 2531 2532 2533 2534 2535 2536 2537 2538 2539
		2540 2541 2543 2546 2547 2548 2559 2560 2561 2569 3225 3226 3227 3228 3229 2550 2551 2552 2553 2554 2555 2556 2557 2558 2549 3230 3231 3232 
		3233 3234 3235 3236 2565 2566 2567 2563 2564 2568 2542 2544 2545 2562 3095 3094 3093 3092 3096 3097 3211 3212 3213 3214 3205 1768 1755 1756 1758 
		1767 1766 1771 1772 1773 1774 1775 1770 1759 1760 1761 1765 1764 1763 1769 3098 1754 1762 2344 2345 2346 2347 2348 2349 2350 2351 2352 2353 2354 
		2343 3099 3149 3151 3152 3153 3155 3157 3158 3159 3160 3161 3163 2355 2356 2357 2358 2359 2360 2361 2362 2363 2364 2479 2480 2481 3154 2372 3109 
		3195 3196 3197 3198 3199 3200 3201 3202 3203 2365 2366 2367 2368 2369 2370 2371 2463 2464 3110 3091 3147 3148 3150 1749 1750 1751 1752 1753 1757 
		1748 3100 3162 3164 3156 1743 1745 499 1742 498 497 496 495 493 2438 2439 2440 2441 3101 3106 3105 3104 3103 3102 492 491 490 489 420 419 418 417 
		487 416 415 484 485 483 414 3186 3185 3184 2472 2474 2475 3187 3188 3189 3165 3166 3167 3168 3169 3170 3171 3172 3173 3174 3107 494 1744 3108 3175 
		3176 3177 3178 2473 2476 2477 2478 1747 1746 2342 3179 3180 3181 3182 3183 3190 3191 402 401 400 399 398 397 396 395 394 393 392 486 481 480 475 
		478 477 476 473 474 457 456 389 390 482 413 412 411 410 409 408 407 406 405 404 403 467 469 470 466 463 464 465 488 471 472 479 461 450 
		449 448 3021 437 439 454 425 422 421 459 452 455 453 388 438 387 424 386 385 384 383 376 375 374 373 377 378 379 371 460 426 440 441
		382 443 444 445 446 447 431 432 433 429 427 434 451 3192 3193 3194 368 370 369 358 360 366 364 361 356 355 354 357 352 365 367 
		359 353 346 347 348 349 350 351 344 343 340 342 339 341 336 334 333 338 337 335 332 3240 3241 3242 3243 3244 3245 3246 3247 3248 3249 3129 3130 3131 3132 
		3133 3134 3135 3136 3137 3138 3139 3140 3141 3142 3142 313 312 316 318 319 314 315 317 330 331 328 329 327 322 321 320 326 325 324 323 310 309 304 305 306 
		308 311  301 302 303 307 3143 3144 3145 3146 3700 3701 3702 1805 1811 1839 1877
		723 1253 1254 1255 1256 1257 1261 1278 1264 1265 1269 1272 1276 1260 1280 1282 1284 1286 1287 1288 1289 
}

asia = {
		1828 1829 1830 1831 1832 1833 1834 1835 733 734 735 736 737 738 741 739 740 742 743 746 731 732 730 774 773 772 769 770 771 767 768 811 744 745 749 750 751 752 753 782 754 783 780
		725 756 755 757 758 747 748 781 787 788 812 784 785 786 789 790 759 760 763 761 762 766 764 765 791 775 776 777 778 819 818 820 823 824 822 821 817 815 779 795 799 798 800 801 
		804 802 805 806 807 808 809 810 792 793 794 796 797 836 831 833 848 832 825 826 828 827 844 845 835 837 838 840 842 843 839 841 857 858 1836 849 847 846 850 851 852 855 853 854 
		1826 1823 1825 1827 1824 1820 1817 2382 1816 1810 3023 3024 1821 3036 3037 3038 3040 3025 1822 1819 1818 1815 1814 1813 1812 1807 1803 1802 1801 1800 1804 1806 1798 1796 1795 
		1791 1792 1793 1794 1799 1797 1808 1809 3039 2333 2334 1789 2335 2331 2338 2339 2337 2340 2341 2431 2432 2433 2593 2596 2570 3113 3114 3115 3116 3117 3118 3119 2571 2572 2573 2574 
		2575 2576 2577 2578 2579 2580 2580 2581 2582 2583 2584 2585 2586 2587 2588 2589 2590 2591 2592 2594 2595 2332 2336 2374 2373 1778 3033 3034 3035 3111 3237 3238 3239 1790 1788 1787 
		1779 1777 1776 3032 3112 1166 1167 1169 1174 1173 1847 1177 1176 1175 1178 1179 1180 1181 1184 1185 1182 1183 859 1841 1857 1842 1850 1840 1862 1859 1860 1861 2297 2306 2303 2307 
		2308 2305 2304 2302 2301 2309 2299 2295 1845 1866 1865 856 1843 1858 2296 2292 1849 2298 1844 1848 2292 2293 2300 1846 1837 1838 2383 2465 2466 3027 3026 3128
		2425 2426 2427 2428 2424 1937 1934 2429 2430 2434 2435 3044 3045 3046 3047 3048 3049 3050 3051 813 814 816 834 830 829 
		3616 3617 3618 3619 3620 3621 3622 3623 3624 3627 3628 3629 3630 3631 3632 3633 3634 3635 3636
		3693 3694 3695 3696 3697 3698 3699 3 3530 298 299 300 391 430 435 436 458 442 468 462 3030 1935
		1882 3029 2470 2469 2471 3124 1931 372 380 3121 1872 1880 1879 3351 1851 1871 2384 3120 3122 3626 3625 1881 381 3123
			
			
}	

sarmatia = {
		1093 1094 1095 1091 1090 1089 1088 1087 1092 1210 1104 1103 1102 1101 1096 1097 1108 1109 1107 1098 1099 1100 1114 1105 1106 1111 1112 1113 1130 1131 1132 1110 1115 1130 1116 1145 1151 1154
		1117 1118 1119 1120 1121 1122 1123 1124 1125 1126 1127 1128 1129 1146 1147 1144 1143 1142 1158 1159 1148 1149 1150 1156 1155 1153 1152 1163 1191 1192 1193 1194 1201 1202 1204 1205 1206 1207 
		1208 1209 2310 2311 2312 2313 2314 2315 1141 1133 1134 1135 1136 1137 1165 1170 1164 1139 1138 1157 1160 1161 1162 1198 1197 1171 1172 1195 1199 1200 1140 1186 1187 1188 1190 1196 1203 1189 
		2328 2326 2327 2325 2324 2323 2320 2316 2317 2321 2318 2322 2329 2330 2418 2419 2449 2450 2451 2446  2460 2461 3053 3052 2486 2487 2488 2489 2490 2491 2492 2493 2494
		3535 3536 3537 3538 3539 3540 3541 3542 3543 3544 3545 3546 3547 3548 3549 3550 3551 3552 3553 3554 3555 3556 3557 3558 3559 3560 3561 1955 1936
}

iran = {
		1870 1867 2385 1864 1868 1869 2467 2468 1873 1874 1875 1878 1855 1856 1863 1944 1943 1854 
		1853 1852 2294 1876 1938 1939 1940 1947 1941 3031 1945 1946 2047 2390 2394 2391 2496 2041 1942 1950 1951 1952 1953 1933 3028 1930 3125 3127 3126 1954 1965 1966 2004 2005 2031 
		1968 1967 1969 1970 1971 1972 1973 2003 1974 3250 1948 1949	2043 2044 2046 2042 2048 2392 3278 2393 2050 2045 2034 2037 2035 2032 2033 2038 2040 2039 2055 2052 2053 2054 2056 
		2057 2058 2051 2036 2060 2059 2064 2072 2069 2071 2073 2070 2413 2412 2066 2065 2067 2074 2407 2414 2408 2409 3041 3042 2410 3055 3056 3054 2406 3280 2397 2398 2396 2415 2416 
		3279 2399 2049 2401 2402 2403 2404 2405 2395 2400 2417 2447 2769 2453 2454 2455 2456 2457 2445 2459 3253 3254 3565 3641 3725 3726 3727 3728 3729 3730 3724 
			
}

china = {
		2770 2771 2772 2773 2774 2775 2776 2777 2778 2779 2780 2781 2782 2791 2792 2793 2794 2795 2783 2796 2797 2798 2799 2800 2801 2802 2803 2804 2805 2874 2875 2876 2877 2878 2858 2859 2860 2861 2862
		2863 2864 2865 2870 2871 2872 2873 2866 2819 2818 2817 2850 2851 2852 2853 2854 2855 2856 2857 2848 2867 2868 2869 2840 2841 2842 2843 2844 2839 2838 
		2845 2846 2847 2849 2828 2830 2829 2827 2825 2837 2831 2832 2814 2815 2816 2807 2810 2806 2808 2811 2820 2821 2809 2922 2923 2924 2920 2919 2921 2928 2927 2929 2890 2926
		2835 2836 2822 2823 2824 2826 2812 2813 2889 2833 2834 2886 2888 2879 2880 2887 2891 2881 2882 2883 2884 2885 2892 2894 2895 2896 2893 2897 2898 2899 2900 2917 
		2918 2914 2915 2916 2909 2910 2911 2901 2902 2903 2904 2905 2906 2907 2908 2912 2913 2930 2931 2935 2936 2942 2941 2947 2932 2937 2943 2946 2948 2945 2940 2939 2944 2938 2933 2934 
		2949 2950 2951 2952 2953 2954 2955 2956 2957 2958 2959 2960 2961 3004 3005 3006 3007 3008 3009 3010 2784 2785 3011 3012 3013 3014 3015 3016 3017 3018 3019 3020 
		3075 3076 3260 3261 3262 3263	3349 3352 3353 3354 3355 3356 3357 3358 3359 3360 3361 3362 3363 3364 3365 3366 3367 3368 3369 3370
		3371 3372 3373 3374 3375 3376 3377 3378 3379 3380 3381 3382 3383 3384 3385 3386 3387 3388 3389 3390 3391 3392 3393 3394 3395 3396 3397 3398 3399 3400 3401 3402 3403 3404 3405 3406 3407
		3408 3409 3411 3414 3415 3416 3417 3418 3419 3420 3421 3422 3423 3424 3425 3426 3427 3428 3429 3430 3431 3432 3433 3434 3435 3436 3437 3438 3439 3440 3441 3442 3443 3444 
		3445 3446 3447 3448 3449
		3450 3451 3452 3453 3454 3455 3456 3457 3458 3459 3460 3461 3462 3463 3464 3465 3466 3467 3468 3469 3470 3471 3472 3473 3474 3475 3476 3477 3478 3479
		3480 3481 3482 3483 3484 3485 3486 3487 3488 3489 3490 3491 3492 3493 3494 3495 3496 2925
		3657 3658 3659 3660 3661 3662 3663 3664 3665 3666 3667 3668 3669 3670 3671 3672 3673 3674 3675 3676 3677 3680 3681 3682 3683
		3684 3685 3686 3687 3688 3689 3690 3691 3692
		
		}
 
india = {
		2411 2075 2610 2602 2601 2603 2604 2607 2605 2606 2608 2611 2609 2616 2617 2062 2626 2061 2063 2624 2621 2613 2612 2614 2620 2623 2622 2629 2615
		2632 2627 2625 2633 2634 2643 2644 2618 2619 2630 2631 2645 2672 2636 2637 2638 2639 2642 2641 2635 2640 2653 2654 2652 2651 2659 
		2668 2667 2678 2677 2676 2675 2679 2680 2662 2663 2664 2666 2665 3265 2688 2689 3264 2700 2690 2699 3266 2681 2682 2683 2684 2685 2686 2687
		2691 2693 2694 2692 3057 3058 2695 2696 2697 2698 3268 3269 2083 3282 3286 3283 3281 2079 2084 3289 3290 2082 3291 2081 2080 3326 3325
		3340 3341 3342 3343 3344 3345 3273 3272 3271 3270 3284 2077 2078 2076 3267 3332 3333 3334 3335 3336 3331 3337 3338 3339 3330 3329 3320 3321 3322 3327 3328
		3287 3288 3324 3323 3292 3294 3295 3293 3316 3317 3318 3319 3315 3314 3313 3310 3301 3302 3303 3304 3305 3306 3307 3308 3309 3296 3297 3298 3299 3300 3312 2657
		2650 2649 2655 2658 2648 2656 2661 2646 2647 2671 2670 2669 2674 2673 3069 3067 3068 3066 3065 3064 3070 3071 3072 3073 3255 3256 3257 3258 3259 3311 3348 3347 3346
		3063 3062 3061 3060 3059 3074 112
		3648 3649 3650 3651 3652 3653 3654 3655 3656
		3733 3734 3735 3736 3737 3738 3739 3740 3741 3742 3743 3744 3745 3746 3747 3748 3749 3750 3751 3752 3753 3754 3755 3756 3757 3758 3759 3760 3761 3762 3763 3764 3765 3766 3767 3768 3769
}

wasteland_continent = {
	1007 1006 108 107 1068 1168 1216 1217 1218 
	1701 1702 1703 1704 1705 1706 1707 2319
	2375 2376 2377 2378 2379 2380 2381
	2386 2387 2388 2389 976 2420 2421 2422 2423 
	2436 2443 2444 2452 2458 2482 2483 2484 2485 
	2499 2500 2761 2762 2768 2767 2765 2766
	2786 2787 2788 2789 2790 2985 2986 2987 2988 2989 2990 2991 2998 2999 3000 3001 3002 3003 3022 3043
	3077 3078 3079 3089 3090 3350 3410 3412 3413 3504 3505 3506 3507 3508 3509 3510 3511 3512 3513 3514
	3515 3516 3517 3518 3519 3520 3521 3522 3523 3524 3526 3527 3528 3529 3531 3532 3533 3534 3562 
	3563 3564 3580 3581 3582 3583 3584 803 3592 3601 3603 3604 3605 3606 3607 3608 3609 3610 3600 3595
	3611 3612 3613 3614 2628 3637 362 345 363 423 3638 3639 3640 6
	294 295 296 297 1291 1292 1293 1301 1302
}	

island_check_provinces = {
}

new_world = {
}