width = 5632
height = 2048

max_provinces = 3771
sea_starts = { 
	1250 1251 1252 1258 1259 1263 1266 1267 1268 1270 1271 1273 1274 
	1275 1277 1279 1281 1283 1285 1290 1294 1295 1297 1298 
	1306 1307 1308 1309 1310 1311 1312 1313 1314 1315 1316 1317 1318 1319 1320 1321 1322 1323 1324 1328 1329 1330 1331 1332
	1333 1334 1335 1336 1337 1338 1339 1340 1341 1342 1343 1344 1345 1346 1347 1348 1349 1350 1351 1352 1353 1354 1355 1356 1357
	1358 1359 1360 1361 1362 1363 1364 1365 1366 1367 1368 1369 1370 1371 1372 1373 1374 1375 1376 1377 1378 1379 1380 1381 1382
	1383 1384 1385 1386 1387 1388 1389 1390 1391 1392 1393 1394 1395 1396 1397 1398 1399 1400 1401 1402 1403 1404 1405 1406 1407
	1408 1409 1410 1411 1412 1413 1414 1415 1416 1417 1418 1419 1420 1421 1422 1423 1424 1425 1426 1427 1428 1429 1430 1431 1432
	1433 1434 1435 1436 1437 1438 1439 1440 1441 1442 1443 1444 1445 1446 1447 1448 1449 1450 1451 1452 1453 1454 1455 1456 1457
	1458 1459 1460 1461 1462 1463 1464 1465 1466 1467 1468 1469 1470 1471 1472 1473 1474 1475 1476 1477 1478 1479 1480 1481 1482
	1483 1484 1485 1486 1487 1488 1489 1490 1491 1492 1493 1494 1495 1496 1497 1498 1499 1500 1501 1502 1503 1504 1505 1506 1507
	1508 1509 1510 1511 1512 1513 1514 1515 1516 1517 1518 1519 1520 1521 1522 1523 1524 1525 1526 1527 1528 1529 1530 1531 1532
	1533 1534 1535 1536 1537 1538 1539 1540 1541 1542 1543 1544 1545 1546 1547 1548 1549 1550 1551 1552 1553 1554 1555 1556 1557
	1558 1559 1560 1561 1562 1563 1564 1565 1566 1567 1568 1569 1570 1571 1572 1573 1574 1575 1576 1577 1578 1579 1580 1581 1582
	1583 1584 1585 1586 1587 1588 1589 1590 1591 1592 1593 1594 1595 1596 1597 1598 1599 1600 1601 1602 1603 1604 1605 1606 1607
	1608 1609 1610 1611 1612 1613 1614 1615 1616 1617 1618 1619 1620 1621 1622 1623 1624 1625 1626 1627 1628 1629 1630 1631 1632
	1633 1634 1635 1636 1637 1638 1639 1640 1641 1642 1643 1644 1645 1646 1647 1648 1649 1650 1651 1652 1653 1654 1655 1656 1657 
	1658 1659 1660 1661 1662 1663 1664 1665 1666 1667 1668 1669 1670 1675 1676 1677 1678 1679 1680 1681 1682 1683 1684 1685 1686 
	1687 1688 1689 1690 1691 1692 1693 1694 1695 1696 1697 1698 1699 1671 1672 1673 1674 1300 1303 1700
	1707 1325 1326 1327
	2701 2702 2703 2704 2705 2706 2707 2708 2709 2710 2711 2712 2713 2714 2715 2716 2717 2718 2719 2720 2721 2722 2723 2724
	2725 2726 2727 2728 2729 2730 2731 2732 2733 2734 2735 2736 2737 2738 2739 2740 2741 2742 2743 2744 2745 2746 2747 2748 2749 
	2750 2751 2752 2753 2754 2755 2756 2757 2758 2759 2760 2763 2764
	2962 2963 2964 2965 2966 2967 2968 2969 2970 2971 2972 2973 2974 2975 2976 2977 2978 2979  2980 2981 2982 2983 2984
	3081 3082 3083 3084 3085 3086 3087 3088 3497 3498 3499 3500 3501 3502 3503 2996 2997 3080 2993 2994 2995 2992
	3419 3420 3421 3422 3423 3424 3425 3426 3506 3508 3509 3510 3511 3512 3505 3504 3732 3770 1262
	3585 3586 3275 1296 1299 3276 3277 1305
}  

only_used_for_random = {
	#RNW Sea provinces	
}

lakes = {
	1708 1709 1710 1711 1712 1713 1714 1715 1716 1717 1718 1719 1720 1721 1722 1723 1724 1725 
	1726 1727 1728 1729 1730 1731 1732 1733 1734 1735 2448 2495 2786 3251 3252 3566 3567 
	3587 3588 3589 3590 3591 3593 3594 3595 3596 3597 3598 3599 3600 3602 1301
	3611 3612 3615 428 3642 3643 3644 3645 3646 3647 3672 3678 3679 3723 3731 
	1291 1292 1293 1302 1304 
}

force_coastal = {
}

definitions = "definition.csv"
provinces = "provinces.bmp"
positions = "positions.txt"
terrain = "terrain.bmp"
rivers = "rivers.bmp"
terrain_definition = "terrain.txt"
heightmap = "heightmap.bmp"
tree_definition = "trees.bmp"
continent = "continent.txt"
adjacencies = "adjacencies.csv"
climate = "climate.txt"
region = "region.txt"
superregion = "superregion.txt"
area = "area.txt"
provincegroup = "provincegroup.txt"
ambient_object = "ambient_object.txt"
seasons = "seasons.txt"
trade_winds = "trade_winds.txt"

canal_definition = {
	name = "nile_canal"
	x = 1658
	y = 889
}

# Define which indices in trees.bmp palette which should count as trees for automatic terrain assignment
tree = { 3 4 7 10 }
